How many singers do we have?	concert_singer
What is the total number of singers?	concert_singer
Show name, country, age for all singers ordered by age from the oldest to the youngest.	concert_singer
What are the names, countries, and ages for every singer in descending order of age?	concert_singer
What is the average, minimum, and maximum age of all singers from France?	concert_singer
What is the average, minimum, and maximum age for all French singers?	concert_singer
Show the name and the release year of the song by the youngest singer.	concert_singer
What are the names and release years for all the songs of the youngest singer?	concert_singer
What are all distinct countries where singers above age 20 are from?	concert_singer
What are  the different countries with singers above age 20?	concert_singer
Show all countries and the number of singers in each country.	concert_singer
How many singers are from each country?	concert_singer
List all song names by singers above the average age.	concert_singer
What are all the song names by singers who are older than average?	concert_singer
Show location and name for all stadiums with a capacity between 5000 and 10000.	concert_singer
What are the locations and names of all stations with capacity between 5000 and 10000?	concert_singer
What is the maximum capacity and the average of all stadiums ?	concert_singer
What is the average and maximum capacities for all stadiums ?	concert_singer
What is the name and capacity for the stadium with highest average attendance?	concert_singer
What is the name and capacity for the stadium with the highest average attendance?	concert_singer
How many concerts are there in year 2014 or 2015?	concert_singer
How many concerts occurred in 2014 or 2015?	concert_singer
Show the stadium name and the number of concerts in each stadium.	concert_singer
For each stadium, how many concerts play there?	concert_singer
Show the stadium name and capacity with most number of concerts in year 2014 or after.	concert_singer
What is the name and capacity of the stadium with the most concerts after 2013 ?	concert_singer
Which year has most number of concerts?	concert_singer
What is the year that had the most concerts?	concert_singer
Show the stadium names without any concert.	concert_singer
What are the names of the stadiums without any concerts?	concert_singer
Show countries where a singer above age 40 and a singer below 30 are from.	concert_singer
Show names for all stadiums except for stadiums having a concert in year 2014.	concert_singer
What are the names of all stadiums that did not have a concert in 2014?	concert_singer
Show the name and theme for all concerts and the number of singers in each concert.	concert_singer
What are the names , themes , and number of singers for every concert ?	concert_singer
List singer names and number of concerts for each singer.	concert_singer
What are the names of the singers and number of concerts for each person?	concert_singer
List all singer names in concerts in year 2014.	concert_singer
What are the names of the singers who performed in a concert in 2014?	concert_singer
what is the name and nation of the singer who have a song having 'Hey' in its name?	concert_singer
What is the name and country of origin of every singer who has a song with the word 'Hey' in its title?	concert_singer
Find the name and location of the stadiums which some concerts happened in the years of both 2014 and 2015.	concert_singer
What are the names and locations of the stadiums that had concerts that occurred in both 2014 and 2015?	concert_singer
Find the number of concerts happened in the stadium with the highest capacity .	concert_singer
What are the number of concerts that occurred in the stadium with the largest capacity ?	concert_singer
Find the number of pets whose weight is heavier than 10.	pets_1
How many pets have a greater weight than 10?	pets_1
Find the weight of the youngest dog.	pets_1
How much does the youngest dog weigh?	pets_1
Find the maximum weight for each type of pet. List the maximum weight and pet type.	pets_1
List the maximum weight and type for each type of pet.	pets_1
Find number of pets owned by students who are older than 20.	pets_1
How many pets are owned by students that have an age greater than 20?	pets_1
Find the number of dog pets that are raised by female students (with sex F).	pets_1
How many dog pets are raised by female students?	pets_1
Find the number of distinct type of pets.	pets_1
How many different types of pet are there?	pets_1
Find the first name of students who have cat or dog pet.	pets_1
What are the first names of every student who has a cat or dog as a pet?	pets_1
Find the first name of students who have both cat and dog pets .	pets_1
What are the students' first names who have both cats and dogs as pets?	pets_1
Find the major and age of students who do not have a cat pet.	pets_1
What major is every student who does not own a cat as a pet, and also how old are they?	pets_1
Find the id of students who do not have a cat pet.	pets_1
What are the ids of the students who do not own cats as pets?	pets_1
Find the first name and age of students who have a dog but do not have a cat as a pet.	pets_1
What is the first name of every student who has a dog but does not have a cat?	pets_1
Find the type and weight of the youngest pet.	pets_1
What type of pet is the youngest animal, and how much does it weigh?	pets_1
Find the id and weight of all pets whose age is older than 1.	pets_1
What is the id and weight of every pet who is older than 1?	pets_1
Find the average and maximum age for each type of pet.	pets_1
What is the average and maximum age for each pet type?	pets_1
Find the average weight for each pet type.	pets_1
What is the average weight for each type of pet?	pets_1
Find the first name and age of students who have a pet.	pets_1
What are the different first names and ages of the students who do have pets?	pets_1
Find the id of the pet owned by student whose last name is ‘Smith’.	pets_1
What is the id of the pet owned by the student whose last name is 'Smith'?	pets_1
Find the number of pets for each student who has any pet and student id.	pets_1
For students who have pets , how many pets does each student have ? list their ids instead of names .	pets_1
Find the first name and gender of student who have more than one pet.	pets_1
What is the first name and gender of the all the students who have more than one pet?	pets_1
Find the last name of the student who has a cat that is age 3.	pets_1
What is the last name of the student who has a cat that is 3 years old?	pets_1
Find the average age of students who do not have any pet .	pets_1
What is the average age for all students who do not own any pets ?	pets_1
How many continents are there?	car_1
What is the number of continents?	car_1
How many countries does each continent have? List the continent id, continent name and the number of countries.	car_1
For each continent, list its id, name, and how many countries it has?	car_1
How many countries are listed?	car_1
How many countries exist?	car_1
How many models does each car maker produce? List maker full name, id and the number.	car_1
What is the full name of each car maker, along with its id and how many models it produces?	car_1
Which model of the car has the minimum horsepower?	car_1
What is the model of the car with the smallest amount of horsepower?	car_1
Find the model of the car whose weight is below the average weight.	car_1
What is the model for the car with a weight smaller than the average?	car_1
Find the name of the makers that produced some cars in the year of 1970?	car_1
What is the name of the different car makers who produced a car in 1970?	car_1
Find the make and production time of the cars that were produced in the earliest year?	car_1
What is the maker of the carr produced in the earliest year and what year was it?	car_1
Which distinct car models are the produced after 1980?	car_1
What are the different models for the cards produced after 1980?	car_1
How many car makers are there in each continents? List the continent name and the count.	car_1
What is the name of each continent and how many car makers are there in each one?	car_1
Which of the countries has the most car makers? List the country name.	car_1
What is the name of the country with the most car makers?	car_1
How many car models are produced by each maker ? Only list the count and the maker full name .	car_1
What is the number of car models that are produced by each maker and what is the id and full name of each maker?	car_1
What is the accelerate of the car make amc hornet sportabout (sw)?	car_1
How much does the car accelerate that makes amc hornet sportabout (sw)?	car_1
How many car makers are there in france?	car_1
What is the number of makers of care in France?	car_1
How many car models are produced in the usa?	car_1
What is the count of the car models produced in the United States?	car_1
What is the average miles per gallon(mpg) of the cars with 4 cylinders?	car_1
What is the average miles per gallon of all the cards with 4 cylinders?	car_1
What is the smallest weight of the car produced with 8 cylinders on 1974 ?	car_1
What is the minimum weight of the car with 8 cylinders produced in 1974 ?	car_1
What are all the makers and models?	car_1
What are the makers and models?	car_1
What are the countries having at least one car maker? List name and id.	car_1
What are the names and ids of all countries with at least one car maker?	car_1
What is the number of the cars with horsepower more than 150?	car_1
What is the number of cars with a horsepower greater than 150?	car_1
What is the average weight of cars each year?	car_1
What is the average weight and year for each year?	car_1
Which countries in europe have at least 3 car manufacturers?	car_1
What are the names of all European countries with at least 3 manufacturers?	car_1
What is the maximum horsepower and the make of the car models with 3 cylinders?	car_1
What is the largest amount of horsepower for the models with 3 cylinders and what make is it?	car_1
Which model saves the most gasoline? That is to say, have the maximum miles per gallon.	car_1
What is the car model with the highest mpg ?	car_1
What is the average horsepower of the cars before 1980?	car_1
What is the average horsepower for all cars produced before 1980 ?	car_1
What is the average edispl of the cars of model volvo?	car_1
What is the average edispl for all volvos?	car_1
What is the maximum accelerate for different number of cylinders?	car_1
What is the maximum accelerate for all the different cylinders?	car_1
Which model has the most version(make) of cars?	car_1
What model has the most different versions?	car_1
How many cars have more than 4 cylinders?	car_1
What is the number of cars with more than 4 cylinders?	car_1
how many cars were produced in 1980?	car_1
In 1980, how many cars were made?	car_1
How many car models were produced by the maker with full name American Motor Company?	car_1
What is the number of car models created by the car maker American Motor Company?	car_1
Which makers designed more than 3 car models? List full name and the id.	car_1
What are the names and ids of all makers with more than 3 models?	car_1
Which distinctive models are produced by maker with the full name General Motors or weighing more than 3500?	car_1
What are the different models created by either the car maker General Motors or weighed more than 3500?	car_1
In which years cars were produced weighing no less than 3000 and no more than 4000 ?	car_1
What are the different years in which there were cars produced that weighed less than 4000 and also cars that weighted more than 3000 ?	car_1
What is the horsepower of the car with the largest accelerate?	car_1
What is the horsepower of the car with the greatest accelerate?	car_1
For model volvo, how many cylinders does the car with the least accelerate have?	car_1
For a volvo model, how many cylinders does the version with least accelerate have?	car_1
How many cars have a larger accelerate than the car with the largest horsepower?	car_1
What is the number of cars with a greater accelerate than the one with the most horsepower?	car_1
How many countries has more than 2 car makers ?	car_1
What is the number of countries with more than 2 car makers ?	car_1
How many cars has over 6 cylinders?	car_1
What is the number of carsw ith over 6 cylinders?	car_1
For the cars with 4 cylinders, which model has the largest horsepower?	car_1
For all of the 4 cylinder cars, which model has the most horsepower?	car_1
Among the cars with more than lowest horsepower, which ones do not have more than 3 cylinders? List the car makeid and make name.	car_1
Among the cars that do not have the minimum horsepower , what are the make ids and names of all those with less than 4 cylinders ?	car_1
What is the maximum miles per gallon of the car with 8 cylinders or produced before 1980 ?	car_1
What is the maximum mpg of the cars that had 8 cylinders or that were produced before 1980 ?	car_1
Which models are lighter than 3500 but not built by the 'Ford Motor Company'?	car_1
What are the different models wthat are lighter than 3500 but were not built by the Ford Motor Company?	car_1
What are the name of the countries where there is not a single car maker?	car_1
What are the names of the countries with no car makers?	car_1
Which are the car makers which produce at least 2 models and more than 3 car makers ? List the id and the maker .	car_1
What are the ids and makers of all car makers that produce at least 2 models and make more than 3 cars?	car_1
What are the id and names of the countries which have more than 3 car makers or produce the 'fiat' model?	car_1
What are the ids and names of all countries that either have more than 3 car makers or produce fiat model ?	car_1
Which country does Airline "JetBlue Airways" belong to?	flight_2
What country is Jetblue Airways affiliated with?	flight_2
What is the abbreviation of Airline "JetBlue Airways"?	flight_2
Which abbreviation corresponds to Jetblue Airways?	flight_2
List all airline names and their abbreviations in "USA".	flight_2
What are the airline names and abbreviations for airlines in the USA?	flight_2
List the airport code and name in the city of Anthony.	flight_2
Give the airport code and airport name corresonding to the city Anthony.	flight_2
How many airlines do we have?	flight_2
What is the total number of airlines?	flight_2
How many airports do we have?	flight_2
Return the number of  airports.	flight_2
How many flights do we have?	flight_2
Return the number of flights.	flight_2
Which airline has abbreviation 'UAL'?	flight_2
Give the airline with abbreviation 'UAL'.	flight_2
How many airlines are from USA?	flight_2
Return the number of airlines in the USA.	flight_2
Which city and country is the Alton airport at?	flight_2
Give the city and country for the Alton airport.	flight_2
What is the airport name for airport 'AKO'?	flight_2
Return the name of the airport with code 'AKO'.	flight_2
What are airport names at City 'Aberdeen'?	flight_2
What are the names of airports in Aberdeen?	flight_2
How many flights depart from 'APG'?	flight_2
Count the number of flights departing from 'APG'.	flight_2
How many flights have destination ATO?	flight_2
Count the number of flights into ATO.	flight_2
How many flights depart from City Aberdeen?	flight_2
Return the number of flights departing from Aberdeen.	flight_2
How many flights arriving in Aberdeen city?	flight_2
Return the number of flights arriving in Aberdeen.	flight_2
How many flights depart from City 'Aberdeen' and have destination City 'Ashley'?	flight_2
How many flights fly from Aberdeen to Ashley?	flight_2
How many flights does airline 'JetBlue Airways' have?	flight_2
Give the number of Jetblue Airways flights.	flight_2
How many 'United Airlines' flights go to Airport 'ASY'?	flight_2
Count the number of United Airlines flights arriving in ASY Airport.	flight_2
How many 'United Airlines' flights depart from Airport 'AHD'?	flight_2
Return the number of United Airlines flights leaving from AHD Airport.	flight_2
How many United Airlines flights go to City 'Aberdeen'?	flight_2
Count the number of United Airlines flights that arrive in Aberdeen.	flight_2
Which city has most number of arriving flights?	flight_2
Which city has the most frequent destination airport?	flight_2
Which city has most number of departing flights?	flight_2
Which city is the most frequent source airport?	flight_2
What is the code of airport that has the highest number of flights?	flight_2
What is the airport code of the airport with the most flights?	flight_2
What is the code of airport that has fewest number of flights?	flight_2
Give the code of the airport with the least flights.	flight_2
Which airline has most number of flights?	flight_2
What airline serves the most flights?	flight_2
Find the abbreviation and country of the airline that has fewest number of flights?	flight_2
What is the abbreviation of the airilne has the fewest flights and what country is it in?	flight_2
What are airlines that have some flight departing from airport 'AHD'?	flight_2
Which airlines have a flight with source airport AHD?	flight_2
What are airlines that have flights arriving at airport 'AHD'?	flight_2
Which airlines have a flight with destination airport AHD?	flight_2
Find all airlines that have flights from both airports 'APG' and 'CVO'.	flight_2
Which airlines have departing flights from both APG and CVO airports?	flight_2
Find all airlines that have flights from airport 'CVO' but not from 'APG'.	flight_2
Which airlines have departures from CVO but not from APG airports?	flight_2
Find all airlines that have at least 10 flights.	flight_2
Which airlines have at least 10 flights?	flight_2
Find all airlines that have fewer than 200 flights.	flight_2
Which airlines have less than 200 flights?	flight_2
What are flight numbers of Airline "United Airlines"?	flight_2
Which flight numbers correspond to United Airlines flights?	flight_2
What are flight numbers of flights departing from Airport "APG"?	flight_2
Give the flight numbers of flights leaving from APG.	flight_2
What are flight numbers of flights arriving at Airport "APG"?	flight_2
Give the flight numbers of flights landing at APG.	flight_2
What are flight numbers of flights departing from City "Aberdeen "?	flight_2
Give the flight numbers of flights leaving from Aberdeen.	flight_2
What are flight numbers of flights arriving at City "Aberdeen"?	flight_2
Give the flight numbers of flights arriving in Aberdeen.	flight_2
Find the number of flights landing in the city of Aberdeen or Abilene.	flight_2
How many flights land in Aberdeen or Abilene?	flight_2
Find the name of airports which do not have any flight in and out.	flight_2
Which airports do not have departing or arriving flights?	flight_2
How many employees are there?	employee_hire_evaluation
Count the number of employees	employee_hire_evaluation
Sort employee names by their age in ascending order.	employee_hire_evaluation
List the names of employees and sort in ascending order of age.	employee_hire_evaluation
What is the number of employees from each city?	employee_hire_evaluation
Count the number of employees for each city.	employee_hire_evaluation
Which cities do more than one employee under age 30 come from?	employee_hire_evaluation
Find the cities that have more than one employee under age 30.	employee_hire_evaluation
Find the number of shops in each location.	employee_hire_evaluation
How many shops are there in each location?	employee_hire_evaluation
Find the manager name and district of the shop whose number of products is the largest.	employee_hire_evaluation
What are the manager name and district of the shop that sells the largest number of products?	employee_hire_evaluation
find the minimum and maximum number of products of all stores.	employee_hire_evaluation
What are the minimum and maximum number of products across all the shops?	employee_hire_evaluation
Return the name, location and district of all shops in descending order of number of products.	employee_hire_evaluation
Sort all the shops by number products in descending order, and return the name, location and district of each shop.	employee_hire_evaluation
Find the names of stores whose number products is more than the average number of products.	employee_hire_evaluation
Which shops' number products is above the average? Give me the shop names.	employee_hire_evaluation
find the name of employee who was awarded the most times in the evaluation.	employee_hire_evaluation
Which employee received the most awards in evaluations? Give me the employee name.	employee_hire_evaluation
Find the name of the employee who got the highest one time bonus.	employee_hire_evaluation
Which employee received the biggest bonus? Give me the employee name.	employee_hire_evaluation
Find the names of employees who never won any award in the evaluation.	employee_hire_evaluation
What are the names of the employees who never received any evaluation?	employee_hire_evaluation
What is the name of the shop that is hiring the largest number of employees?	employee_hire_evaluation
Which shop has the most employees? Give me the shop name.	employee_hire_evaluation
Find the name of the shops that do not hire any employee.	employee_hire_evaluation
Which shops run with no employees? Find the shop names	employee_hire_evaluation
Find the number of employees hired in each shop; show the shop name as well.	employee_hire_evaluation
For each shop, return the number of employees working there and the name of the shop.	employee_hire_evaluation
What is total bonus given in all evaluations?	employee_hire_evaluation
Find the total amount of bonus given in all the evaluations.	employee_hire_evaluation
Give me all the information about hiring.	employee_hire_evaluation
What is all the information about hiring?	employee_hire_evaluation
Which district has both stores with less than 3000 products and stores with more than 10000 products?	employee_hire_evaluation
Find the districts in which there are both shops selling less than 3000 products and shops selling more than 10000 products.	employee_hire_evaluation
How many different store locations are there?	employee_hire_evaluation
Count the number of distinct store locations.	employee_hire_evaluation
How many documents do we have?	cre_Doc_Template_Mgt
Count the number of documents.	cre_Doc_Template_Mgt
List document IDs, document names, and document descriptions for all documents.	cre_Doc_Template_Mgt
What are the ids, names, and descriptions for all documents?	cre_Doc_Template_Mgt
What is the document name and template id for document with description with the letter 'w' in it?	cre_Doc_Template_Mgt
Return the names and template ids for documents that contain the letter w in their description.	cre_Doc_Template_Mgt
What is the document id, template id and description for document named "Robbin CV"?	cre_Doc_Template_Mgt
Return the document id, template id, and description for the document with the name Robbin CV.	cre_Doc_Template_Mgt
How many different templates do all document use?	cre_Doc_Template_Mgt
Count the number of different templates used for documents.	cre_Doc_Template_Mgt
How many documents are using the template with type code 'PPT'?	cre_Doc_Template_Mgt
Count the number of documents that use the PPT template type.	cre_Doc_Template_Mgt
Show all template ids and number of documents using each template.	cre_Doc_Template_Mgt
What are all different template ids used for documents, and how many times were each of them used?	cre_Doc_Template_Mgt
What is the id and type code for the template used by the most documents?	cre_Doc_Template_Mgt
Return the id and type code of the template that is used for the greatest number of documents.	cre_Doc_Template_Mgt
Show ids for all templates that are used by more than one document.	cre_Doc_Template_Mgt
What are the template ids of any templates used in more than a single document?	cre_Doc_Template_Mgt
Show ids for all templates not used by any document.	cre_Doc_Template_Mgt
What are the ids for templates that are not used in any documents?	cre_Doc_Template_Mgt
How many templates do we have?	cre_Doc_Template_Mgt
Count the number of templates.	cre_Doc_Template_Mgt
Show template ids, version numbers, and template type codes for all templates.	cre_Doc_Template_Mgt
What are the ids, version numbers, and type codes for each template?	cre_Doc_Template_Mgt
Show all distinct template type codes for all templates.	cre_Doc_Template_Mgt
What are the different template type codes?	cre_Doc_Template_Mgt
What are the ids of templates with template type code PP or PPT?	cre_Doc_Template_Mgt
Return the ids of templates that have the code PP or PPT.	cre_Doc_Template_Mgt
How many templates have template type code CV?	cre_Doc_Template_Mgt
Count the number of templates of the type CV.	cre_Doc_Template_Mgt
What is the version number and template type code for the template with version number later than 5?	cre_Doc_Template_Mgt
Return the version numbers and template type codes of templates with a version number greater than 5.	cre_Doc_Template_Mgt
Show all template type codes and number of templates for each.	cre_Doc_Template_Mgt
What are the different template type codes, and how many templates correspond to each?	cre_Doc_Template_Mgt
Which template type code has most number of templates?	cre_Doc_Template_Mgt
Return the type code of the template type that the most templates belong to.	cre_Doc_Template_Mgt
Show all template type codes with less than three templates.	cre_Doc_Template_Mgt
What are the codes of template types that have fewer than 3 templates?	cre_Doc_Template_Mgt
What the smallest version number and its template type code?	cre_Doc_Template_Mgt
Return the lowest version number, along with its corresponding template type code.	cre_Doc_Template_Mgt
What is the template type code of the template used by document with the name "Data base"?	cre_Doc_Template_Mgt
Return the template type code of the template that is used by a document named Data base.	cre_Doc_Template_Mgt
Show all document names using templates with template type code BK.	cre_Doc_Template_Mgt
What are the names of documents that use templates with the code BK?	cre_Doc_Template_Mgt
Show all template type codes and the number of documents using each type.	cre_Doc_Template_Mgt
What are the different template type codes, and how many documents use each type?	cre_Doc_Template_Mgt
Which template type code is used by most number of documents?	cre_Doc_Template_Mgt
Return the code of the template type that is most commonly used in documents.	cre_Doc_Template_Mgt
Show all template type codes that are not used by any document.	cre_Doc_Template_Mgt
What are the codes of template types that are not used for any document?	cre_Doc_Template_Mgt
Show all template type codes and descriptions.	cre_Doc_Template_Mgt
What are the type codes and descriptions for all template types?	cre_Doc_Template_Mgt
What is the template type descriptions for template type code "AD".	cre_Doc_Template_Mgt
Return the template type description of the template type with the code AD.	cre_Doc_Template_Mgt
What is the template type code for template type description "Book".	cre_Doc_Template_Mgt
Return the type code of the template type with the description "Book".	cre_Doc_Template_Mgt
What are the distinct template type descriptions for the templates ever used by any document?	cre_Doc_Template_Mgt
Return the different descriptions for templates that have been used in a document.	cre_Doc_Template_Mgt
What are the template ids with template type description "Presentation".	cre_Doc_Template_Mgt
Return the ids corresponding to templates with the description 'Presentation'.	cre_Doc_Template_Mgt
How many paragraphs in total?	cre_Doc_Template_Mgt
Count the number of paragraphs.	cre_Doc_Template_Mgt
How many paragraphs for the document with name 'Summer Show'?	cre_Doc_Template_Mgt
Count the number of paragraphs in the document named 'Summer Show'.	cre_Doc_Template_Mgt
Show paragraph details for paragraph with text 'Korea ' .	cre_Doc_Template_Mgt
What are the details for the paragraph that includes the text 'Korea ' ?	cre_Doc_Template_Mgt
Show all paragraph ids and texts for the document with name 'Welcome to NY'.	cre_Doc_Template_Mgt
What are the ids and texts of paragraphs in the document titled 'Welcome to NY'?	cre_Doc_Template_Mgt
Show all paragraph texts for the document "Customer reviews".	cre_Doc_Template_Mgt
What are the paragraph texts for the document with the name 'Customer reviews'?	cre_Doc_Template_Mgt
Show all document ids and the number of paragraphs in each document. Order by document id.	cre_Doc_Template_Mgt
Return the different document ids along with the number of paragraphs corresponding to each, ordered by id.	cre_Doc_Template_Mgt
Show all document ids, names and the number of paragraphs in each document.	cre_Doc_Template_Mgt
What are the ids and names of each document, as well as the number of paragraphs in each?	cre_Doc_Template_Mgt
List all document ids with at least two paragraphs.	cre_Doc_Template_Mgt
What are the ids of documents that have 2 or more paragraphs?	cre_Doc_Template_Mgt
What is the document id and name with greatest number of paragraphs?	cre_Doc_Template_Mgt
Return the id and name of the document with the most paragraphs.	cre_Doc_Template_Mgt
What is the document id with least number of paragraphs?	cre_Doc_Template_Mgt
Return the id of the document with the fewest paragraphs.	cre_Doc_Template_Mgt
What is the document id with 1 to 2 paragraphs?	cre_Doc_Template_Mgt
Give the ids of documents that have between one and two paragraphs.	cre_Doc_Template_Mgt
Show the document id with paragraph text 'Brazil' and 'Ireland'.	cre_Doc_Template_Mgt
What are the ids of documents that contain the paragraph text 'Brazil' and 'Ireland'?	cre_Doc_Template_Mgt
How many teachers are there?	course_teach
What is the total count of teachers?	course_teach
List the names of teachers in ascending order of age.	course_teach
What are the names of the teachers ordered by ascending age?	course_teach
What are the age and hometown of teachers?	course_teach
What is the age and hometown of every teacher?	course_teach
List the name of teachers whose hometown is not `` Little Lever Urban District '' .	course_teach
What are the names of the teachers whose hometown is not `` Little Lever Urban District '' ?	course_teach
Show the name of teachers aged either 32 or 33?	course_teach
What are the names of the teachers who are aged either 32 or 33?	course_teach
What is the hometown of the youngest teacher?	course_teach
Where is the youngest teacher from?	course_teach
Show different hometown of teachers and the number of teachers from each hometown.	course_teach
For each hometown, how many teachers are there?	course_teach
List the most common hometown of teachers.	course_teach
What is the most commmon hometowns for teachers?	course_teach
Show the hometowns shared by at least two teachers.	course_teach
What are the towns from which at least two teachers come from?	course_teach
Show names of teachers and the courses they are arranged to teach.	course_teach
What is the name of each teacher and what course they teach?	course_teach
Show names of teachers and the courses they are arranged to teach in ascending alphabetical order of the teacher's name.	course_teach
What are the names of the teachers and the courses they teach in ascending alphabetical order by the name of the teacher?	course_teach
Show the name of the teacher for the math course.	course_teach
What are the names of the people who teach math courses?	course_teach
Show names of teachers and the number of courses they teach.	course_teach
What are the names of the teachers and how many courses do they teach?	course_teach
Show names of teachers that teach at least two courses.	course_teach
What are the names of the teachers who teach at least two courses?	course_teach
List the names of teachers who have not been arranged to teach courses.	course_teach
What are the names of the teachers whose courses have not been arranged?	course_teach
How many visitors below age 30 are there?	museum_visit
Find the names of the visitors whose membership level is higher than 4, and order the results by the level from high to low.	museum_visit
What is the average age of the visitors whose membership level is not higher than 4?	museum_visit
Find the name and membership level of the visitors whose membership level is higher than 4, and sort by their age from old to young.	museum_visit
Find the id and name of the museum that has the most staff members?	museum_visit
Find the average number of staff working for the museums that were open before 2009.	museum_visit
What are the opening year and staff number of the museum named Plaza Museum?	museum_visit
find the names of museums which have more staff than the minimum staff number of all museums opened after 2010.	museum_visit
find the id, name and age for visitors who visited some museums more than once.	museum_visit
What are the id, name and membership level of visitors who have spent the largest amount of money in total in all museum tickets?	museum_visit
What are the id and name of the museum visited most times?	museum_visit
What is the name of the museum that had no visitor yet?	museum_visit
Find the name and age of the visitor who bought the most tickets at once.	museum_visit
What are the average and maximum number of tickets bought in all visits?	museum_visit
What is the total ticket expense of the visitors whose membership level is 1?	museum_visit
What is the name of the visitor who visited both a museum opened before 2009 and a museum opened after 2011?	museum_visit
Find the number of visitors who did not visit any museum opened after 2010.	museum_visit
How many museums were opened after 2013 or before 2008?	museum_visit
Find the total number of players.	wta_1
How many players are there?	wta_1
Find the total number of matches.	wta_1
Count the number of matches.	wta_1
List the first name and birth date of all players from the country with code USA.	wta_1
What are the first names and birth dates of players from the USA?	wta_1
Find the average age of losers and winners of all matches.	wta_1
What are the average ages of losers and winners across matches?	wta_1
Find the average rank of winners in all matches.	wta_1
What is the average rank for winners in all matches?	wta_1
Find the highest rank of losers in all matches.	wta_1
What is the best rank of losers across all matches?	wta_1
find the number of distinct country codes of all players.	wta_1
How many distinct countries do players come from?	wta_1
Find the number of distinct name of losers.	wta_1
How many different loser names are there?	wta_1
Find the name of tourney that has more than 10 matches.	wta_1
What are the names of tournaments that have more than 10 matches?	wta_1
List the names of all winners who played in both 2013 and 2016.	wta_1
What are the names of players who won in both 2013 and 2016?	wta_1
List the number of all matches who played in years of 2013 or 2016.	wta_1
How many matches were played in 2013 or 2016?	wta_1
What are the country code and first name of the players who won in both tourney WTA Championships and Australian Open?	wta_1
What are the first names and country codes for players who won both the WTA Championships and the Australian Open?	wta_1
Find the first name and country code of the oldest player.	wta_1
What is the first name and country code of the oldest player?	wta_1
List the first and last name of all players in the order of birth date.	wta_1
What are the full names of all players, sorted by birth date?	wta_1
List the first and last name of all players who are left / L hand in the order of birth date.	wta_1
What are the full names of all left handed players, in order of birth date?	wta_1
Find the first name and country code of the player who did the most number of tours.	wta_1
What is the first name and country code of the player with the most tours?	wta_1
Find the year that has the most number of matches.	wta_1
Which year had the most matches?	wta_1
Find the name and rank points of the winner who won the most times.	wta_1
What is the name of the winner who has won the most matches, and how many rank points does this player have?	wta_1
Find the name of the winner who has the highest rank points and participated in the Australian Open tourney.	wta_1
What is the name of the winner with the most rank points who participated in the Australian Open tournament?	wta_1
find the names of loser and winner who played in the match with greatest number of minutes.	wta_1
What are the names of the winner and loser who played in the longest match?	wta_1
Find the average ranking for each player and their first name.	wta_1
What are the first names of all players, and their average rankings?	wta_1
Find the total ranking points for each player and their first name.	wta_1
What are the first names of all players, and their total ranking points?	wta_1
find the number of players for each country.	wta_1
How many players are from each country?	wta_1
find the code of the country where has the greatest number of players.	wta_1
What is the code of the country with the most players?	wta_1
Find the codes of countries that have more than 50 players.	wta_1
What are the codes of countries with more than 50 players?	wta_1
Find the total number of tours for each ranking date.	wta_1
How many total tours were there for each ranking date?	wta_1
Find the number of matches happened in each year.	wta_1
How many matches were played in each year?	wta_1
Find the name and rank of the 3 youngest winners across all matches.	wta_1
What are the names and ranks of the three youngest winners across all matches?	wta_1
How many different winners both participated in the WTA Championships and were left handed?	wta_1
Find the number of left handed winners who participated in the WTA Championships.	wta_1
Find the first name, country code and birth date of the winner who has the highest rank points in all matches.	wta_1
What is the first name, country code, and birth date of the player with the most winner rank points across all matches?	wta_1
Find the number of players for each hand type.	wta_1
How many players are there for each hand type?	wta_1
How many ships ended up being 'Captured'?	battle_death
List the name and tonnage ordered by in descending alphaetical order for the names.	battle_death
List the name, date and result of each battle.	battle_death
What is maximum and minimum death toll caused each time?	battle_death
What is the average number of injuries caused each time?	battle_death
What are the death and injury situations caused by the ship with tonnage 't'?	battle_death
What are the name and results of the battles when the bulgarian commander is not 'Boril'	battle_death
What are the different ids and names of the battles that lost any 'Brig' type shipes?	battle_death
What are the ids and names of the battles that led to more than 10 people killed in total.	battle_death